═════════════════════
║   ║       ║   ║   ║
║ ║ ║ ═════ ║ ═══ ║ ║
║ ║ ║ ║   ║ ║     ║ ║
║ ═══ ║ ║ ║ ═══════ ║
║     ║ ║ ║         ║
║════════ ║ ═══════ ║
║         ║     ║ ║ ║
║ ║ ═════ ║ ═════ ║ ║
║ ║     ║ ║ ║     ║ ║
║ ║═════║ ║═║ ║ ║ ║ ║
║ ║     ║ ║ ║ ║ ║ ║ ║
║ ║ ═══ ║ ║ ══║ ║ ║ ║
║ ║ ║ ║ ║ ║   ║ ║ ║ ║
║ ║ ║ ║ ║ ║══ ║ ║ ║ ║
║ ║   ║   ║ ║ ║ ║ ║ ║
║ ═════════ ║ ║ ║ ║ ║
║           ║   ║ ║ ║
║ ║ ═══ ═══ ═════ ║ ║
║ ║   ║   ║         ║
═════════════════════
