══════════════════════
║        ║         ║ ║
║ ══════ ║ ═══════ ║ ║
║      ║   ║     ║ ║ ║
║═══════ ═══ ═════ ║ ║
║        ║         ║ ║
║ ═══════║ ════ ════ ║
║        ║    ║      ║
║═════════════════ ══║
║                ║ ║ ║
║ ══════════════ ║ ║ ║
║ ║    ║       ║ ║ ║ ║
║ ║═══ ║ ═══ ═══ ║ ║ ║
║ ║    ║ ║ ║ ║     ║ ║
║ ║ ════ ║ ║ ║ ═══ ║ ║
║ ║        ║ ║ ║ ║ ║ ║
║ ║ ═══════║ ║ ║ ║ ║ ║
║ ║        ║ ║ ║ ║ ║ ║
║ ══════════ ║ ║ ║ ║ ║
║            ║   ║   ║
══════════════════════
