══════════════════════
║         ║        ║ ║
║ ═══════ ║ ══════ ║ ║
║      ║    ║    ║ ║ ║
║═══════ ════ ════ ║ ║
║        ║         ║ ║
║ ═══════║ ═════ ═══ ║
║        ║     ║     ║
║═════════════════ ══║
║                ║ ║ ║
║ ══════════════ ║ ║ ║
║ ║    ║       ║ ║ ║ ║
║ ║═══ ║ ═══ ═══ ║ ║ ║
║ ║    ║ ║ ║ ║     ║ ║
║ ║ ════ ║ ║ ║ ═══ ║ ║
║ ║        ║ ║ ║ ║ ║ ║
║ ║ ═══════║ ║ ║ ║ ║ ║
║ ║        ║ ║ ║ ║ ║ ║
║ ══════════ ║ ║ ║ ║ ║
║            ║   ║   ║
══════════════════════
